#,#,#,#,#,#,#,#
#,X,#,,,,,#
#,,#,,#,#,,#
#,,,,#,#,,#
#,,#,#,,,,#
#,,#,#,,#,#,#
#,,#,,,,,E
#,#,#,#,#,#,#,#
